111111111
100000C01
10P000001
10C0E0001
10000001
111111111