111111111
100000C01
100000001
10C000001
1000000E1
111111111