111111111
100000C01
10P000001
10C000001
100000E01
111111110